im interested in datasets related to depend	search depend
im interested in datasets related to wolf	search wolf
im interested in datasets related to ambition	search ambition
im interested in datasets related to jet	search jet
im interested in datasets related to economist	search economist
im interested in datasets related to point	search point
im interested in datasets related to weed	search weed
im interested in datasets related to competition	search competition
im interested in datasets related to shareholder	search shareholder
im interested in datasets related to wien	search wien
im interested in datasets related to science	search science
im interested in datasets related to collection	search collection
im interested in datasets related to suite	search suite
im interested in datasets related to bathtub	search bathtub
im interested in datasets related to distinct	search distinct
im interested in datasets related to austria	search austria
im interested in datasets related to housewife	search housewife
im interested in datasets related to shallow	search shallow
im interested in datasets related to doll	search doll
im interested in datasets related to railroad	search railroad
im interested in datasets related to rebel	search rebel
im interested in datasets related to pound	search pound
im interested in datasets related to recommend	search recommend
im interested in datasets related to classify	search classify
im interested in datasets related to motorist	search motorist
im interested in datasets related to topple	search topple
im interested in datasets related to break down	search break down
im interested in datasets related to entitlement	search entitlement
im interested in datasets related to reference	search reference
im interested in datasets related to resident	search resident
im interested in datasets related to vienna	search vienna
im interested in datasets related to referee	search referee
im interested in datasets related to academy	search academy
im interested in datasets related to essential	search essential
im interested in datasets related to alive	search alive
im interested in datasets related to epicalyx	search epicalyx
im interested in datasets related to twilight	search twilight
im interested in datasets related to man	search man
im interested in datasets related to likely	search likely
im interested in datasets related to urgency	search urgency
have you got something on austria or dogs	search austria dogs
have you got something on doll or alive	search doll alive
have you got something on break down or major	search break down major
have you got something on manner or wolf	search manner wolf
have you got something on housewife or economist	search housewife economist
have you got something on topple or point	search topple point
have you got something on urgency or depend	search urgency depend
have you got something on belt or aluminium	search belt aluminium
have you got something on referee or recommend	search referee recommend
have you got something on expectation or shareholder	search expectation shareholder
have you got something on twilight or science	search twilight science
have you got something on residence or distinct	search residence distinct
have you got something on resident or vegetable	search resident vegetable
have you got something on bathtub or pound	search bathtub pound
have you got something on north or motorist	search north motorist
have you got something on escape or vienna	search escape vienna
have you got something on man or collection	search man collection
have you got something on vertical or rebel	search vertical rebel
have you got something on epicalyx or ambition	search epicalyx ambition
have you got something on entitlement or railroad	search entitlement railroad
have you got something on suite or shallow	search suite shallow
have you got something on weed or jet	search weed jet
have you got something on tourist or deserve	search tourist deserve
have you got something on wien or reform	search wien reform
have you got something on essential or likely	search essential likely
have you got something on classify or academy	search classify academy
have you got something on competition or reference	search competition reference
data about competition	search competition
data about aluminium	search aluminium
data about motorist	search motorist
data about break down	search break down
data about science	search science
data about housewife	search housewife
data about bathtub	search bathtub
data about referee	search referee
data about weed	search weed
data about shallow	search shallow
data about escape	search escape
data about manner	search manner
data about north	search north
data about academy	search academy
data about resident	search resident
data about wolf	search wolf
data about rebel	search rebel
data about man	search man
data about recommend	search recommend
data about dogs	search dogs
data about residence	search residence
data about depend	search depend
data about deserve	search deserve
data about economist	search economist
data about vienna	search vienna
data about shareholder	search shareholder
data about essential	search essential
data about austria	search austria
data about major	search major
data about wien	search wien
data about entitlement	search entitlement
data about pound	search pound
data about tourist	search tourist
data about reference	search reference
data about doll	search doll
data about vegetable	search vegetable
data about ambition	search ambition
data about expectation	search expectation
data about vertical	search vertical
data about distinct	search distinct
what do you know about referee	search referee
what do you know about point	search point
what do you know about ambition	search ambition
what do you know about railroad	search railroad
what do you know about reform	search reform
what do you know about depend	search depend
what do you know about collection	search collection
what do you know about suite	search suite
what do you know about essential	search essential
what do you know about austria	search austria
what do you know about rebel	search rebel
what do you know about major	search major
what do you know about shallow	search shallow
what do you know about aluminium	search aluminium
what do you know about housewife	search housewife
what do you know about shareholder	search shareholder
what do you know about twilight	search twilight
what do you know about alive	search alive
what do you know about academy	search academy
what do you know about distinct	search distinct
what do you know about topple	search topple
what do you know about wolf	search wolf
what do you know about classify	search classify
what do you know about pound	search pound
what do you know about wien	search wien
what do you know about urgency	search urgency
what do you know about vienna	search vienna
what do you know about manner	search manner
what do you know about deserve	search deserve
what do you know about north	search north
what do you know about residence	search residence
what do you know about motorist	search motorist
what do you know about belt	search belt
what do you know about vegetable	search vegetable
what do you know about dogs	search dogs
what do you know about break down	search break down
what do you know about competition	search competition
what do you know about science	search science
what do you know about reference	search reference
what do you know about tourist	search tourist
north	search north
railroad	search railroad
expectation	search expectation
epicalyx	search epicalyx
vienna	search vienna
twilight	search twilight
deserve	search deserve
aluminium	search aluminium
jet	search jet
motorist	search motorist
referee	search referee
dogs	search dogs
escape	search escape
essential	search essential
wolf	search wolf
classify	search classify
wien	search wien
vegetable	search vegetable
pound	search pound
likely	search likely
reform	search reform
shallow	search shallow
austria	search austria
competition	search competition
break down	search break down
ambition	search ambition
weed	search weed
belt	search belt
collection	search collection
entitlement	search entitlement
man	search man
bathtub	search bathtub
alive	search alive
point	search point
tourist	search tourist
topple	search topple
science	search science
depend	search depend
shareholder	search shareholder
distinct	search distinct
is there something on urgency	search urgency
is there something on doll	search doll
is there something on twilight	search twilight
is there something on jet	search jet
is there something on distinct	search distinct
is there something on essential	search essential
is there something on shallow	search shallow
is there something on resident	search resident
is there something on wolf	search wolf
is there something on aluminium	search aluminium
is there something on belt	search belt
is there something on economist	search economist
is there something on major	search major
is there something on alive	search alive
is there something on academy	search academy
is there something on likely	search likely
is there something on vienna	search vienna
is there something on collection	search collection
is there something on tourist	search tourist
is there something on topple	search topple
is there something on point	search point
is there something on rebel	search rebel
is there something on motorist	search motorist
is there something on pound	search pound
is there something on escape	search escape
is there something on depend	search depend
is there something on reform	search reform
is there something on referee	search referee
is there something on weed	search weed
is there something on ambition	search ambition
is there something on manner	search manner
is there something on deserve	search deserve
is there something on reference	search reference
is there something on housewife	search housewife
is there something on residence	search residence
is there something on expectation	search expectation
is there something on austria	search austria
is there something on man	search man
is there something on suite	search suite
is there something on vegetable	search vegetable
i am looking for datasets about alive	search alive
i am looking for datasets about essential	search essential
i am looking for datasets about entitlement	search entitlement
i am looking for datasets about point	search point
i am looking for datasets about resident	search resident
i am looking for datasets about shareholder	search shareholder
i am looking for datasets about vegetable	search vegetable
i am looking for datasets about deserve	search deserve
i am looking for datasets about recommend	search recommend
i am looking for datasets about wolf	search wolf
i am looking for datasets about reform	search reform
i am looking for datasets about suite	search suite
i am looking for datasets about north	search north
i am looking for datasets about jet	search jet
i am looking for datasets about reference	search reference
i am looking for datasets about classify	search classify
i am looking for datasets about likely	search likely
i am looking for datasets about twilight	search twilight
i am looking for datasets about distinct	search distinct
i am looking for datasets about break down	search break down
i am looking for datasets about austria	search austria
i am looking for datasets about depend	search depend
i am looking for datasets about escape	search escape
i am looking for datasets about tourist	search tourist
i am looking for datasets about man	search man
i am looking for datasets about vienna	search vienna
i am looking for datasets about aluminium	search aluminium
i am looking for datasets about weed	search weed
i am looking for datasets about epicalyx	search epicalyx
i am looking for datasets about rebel	search rebel
i am looking for datasets about wien	search wien
i am looking for datasets about manner	search manner
i am looking for datasets about expectation	search expectation
i am looking for datasets about science	search science
i am looking for datasets about major	search major
i am looking for datasets about vertical	search vertical
i am looking for datasets about pound	search pound
i am looking for datasets about urgency	search urgency
i am looking for datasets about shallow	search shallow
i am looking for datasets about ambition	search ambition
data on topple	search topple
data on reform	search reform
data on vienna	search vienna
data on academy	search academy
data on dogs	search dogs
data on depend	search depend
data on suite	search suite
data on alive	search alive
data on wien	search wien
data on jet	search jet
data on aluminium	search aluminium
data on shallow	search shallow
data on major	search major
data on classify	search classify
data on science	search science
data on pound	search pound
data on bathtub	search bathtub
data on residence	search residence
data on ambition	search ambition
data on entitlement	search entitlement
data on austria	search austria
data on vertical	search vertical
data on housewife	search housewife
data on likely	search likely
data on recommend	search recommend
data on referee	search referee
data on escape	search escape
data on distinct	search distinct
data on shareholder	search shareholder
data on deserve	search deserve
data on motorist	search motorist
data on reference	search reference
data on twilight	search twilight
data on weed	search weed
data on north	search north
data on essential	search essential
data on doll	search doll
data on epicalyx	search epicalyx
data on break down	search break down
data on rebel	search rebel
i am interested in data about weed	search weed
i am interested in data about depend	search depend
i am interested in data about housewife	search housewife
i am interested in data about deserve	search deserve
i am interested in data about major	search major
i am interested in data about referee	search referee
i am interested in data about science	search science
i am interested in data about economist	search economist
i am interested in data about collection	search collection
i am interested in data about rebel	search rebel
i am interested in data about classify	search classify
i am interested in data about jet	search jet
i am interested in data about belt	search belt
i am interested in data about alive	search alive
i am interested in data about vertical	search vertical
i am interested in data about resident	search resident
i am interested in data about pound	search pound
i am interested in data about wien	search wien
i am interested in data about reference	search reference
i am interested in data about austria	search austria
i am interested in data about railroad	search railroad
i am interested in data about expectation	search expectation
i am interested in data about motorist	search motorist
i am interested in data about escape	search escape
i am interested in data about topple	search topple
i am interested in data about essential	search essential
i am interested in data about vegetable	search vegetable
i am interested in data about doll	search doll
i am interested in data about north	search north
i am interested in data about entitlement	search entitlement
i am interested in data about tourist	search tourist
i am interested in data about ambition	search ambition
i am interested in data about residence	search residence
i am interested in data about competition	search competition
i am interested in data about point	search point
i am interested in data about manner	search manner
i am interested in data about shareholder	search shareholder
i am interested in data about urgency	search urgency
i am interested in data about break down	search break down
i am interested in data about likely	search likely
my interest is in referee	search referee
my interest is in bathtub	search bathtub
my interest is in ambition	search ambition
my interest is in dogs	search dogs
my interest is in housewife	search housewife
my interest is in likely	search likely
my interest is in epicalyx	search epicalyx
my interest is in recommend	search recommend
my interest is in distinct	search distinct
my interest is in wien	search wien
my interest is in doll	search doll
my interest is in science	search science
my interest is in shallow	search shallow
my interest is in depend	search depend
my interest is in tourist	search tourist
my interest is in man	search man
my interest is in reference	search reference
my interest is in wolf	search wolf
my interest is in urgency	search urgency
my interest is in railroad	search railroad
my interest is in twilight	search twilight
my interest is in reform	search reform
my interest is in major	search major
my interest is in expectation	search expectation
my interest is in suite	search suite
my interest is in academy	search academy
my interest is in topple	search topple
my interest is in shareholder	search shareholder
my interest is in vegetable	search vegetable
my interest is in resident	search resident
my interest is in belt	search belt
my interest is in deserve	search deserve
my interest is in point	search point
my interest is in classify	search classify
my interest is in break down	search break down
my interest is in economist	search economist
my interest is in alive	search alive
my interest is in residence	search residence
my interest is in austria	search austria
my interest is in vertical	search vertical
im interested in data related to alive	search alive
im interested in data related to motorist	search motorist
im interested in data related to rebel	search rebel
im interested in data related to economist	search economist
im interested in data related to vienna	search vienna
im interested in data related to science	search science
im interested in data related to academy	search academy
im interested in data related to housewife	search housewife
im interested in data related to urgency	search urgency
im interested in data related to man	search man
im interested in data related to dogs	search dogs
im interested in data related to aluminium	search aluminium
im interested in data related to ambition	search ambition
im interested in data related to vegetable	search vegetable
im interested in data related to belt	search belt
im interested in data related to escape	search escape
im interested in data related to expectation	search expectation
im interested in data related to entitlement	search entitlement
im interested in data related to resident	search resident
im interested in data related to tourist	search tourist
im interested in data related to essential	search essential
im interested in data related to point	search point
im interested in data related to recommend	search recommend
im interested in data related to reform	search reform
im interested in data related to austria	search austria
im interested in data related to suite	search suite
im interested in data related to bathtub	search bathtub
im interested in data related to weed	search weed
im interested in data related to shallow	search shallow
im interested in data related to major	search major
im interested in data related to shareholder	search shareholder
im interested in data related to depend	search depend
im interested in data related to break down	search break down
im interested in data related to vertical	search vertical
im interested in data related to jet	search jet
im interested in data related to epicalyx	search epicalyx
im interested in data related to likely	search likely
im interested in data related to residence	search residence
im interested in data related to distinct	search distinct
im interested in data related to manner	search manner
what about wien	search wien
what about competition	search competition
what about manner	search manner
what about twilight	search twilight
what about essential	search essential
what about aluminium	search aluminium
what about topple	search topple
what about rebel	search rebel
what about major	search major
what about bathtub	search bathtub
what about north	search north
what about collection	search collection
what about escape	search escape
what about reform	search reform
what about referee	search referee
what about epicalyx	search epicalyx
what about tourist	search tourist
what about academy	search academy
what about economist	search economist
what about vienna	search vienna
what about dogs	search dogs
what about entitlement	search entitlement
what about housewife	search housewife
what about railroad	search railroad
what about weed	search weed
what about pound	search pound
what about deserve	search deserve
what about jet	search jet
what about recommend	search recommend
what about shallow	search shallow
what about ambition	search ambition
what about alive	search alive
what about vegetable	search vegetable
what about suite	search suite
what about distinct	search distinct
what about point	search point
what about break down	search break down
what about reference	search reference
what about classify	search classify
what about motorist	search motorist
i am interested in essential and resident	search essential resident
i am interested in shallow and point	search shallow point
i am interested in weed and manner	search weed manner
i am interested in recommend and deserve	search recommend deserve
i am interested in railroad and aluminium	search railroad aluminium
i am interested in dogs and escape	search dogs escape
i am interested in break down and tourist	search break down tourist
i am interested in classify and reference	search classify reference
i am interested in motorist and twilight	search motorist twilight
i am interested in expectation and economist	search expectation economist
i am interested in doll and housewife	search doll housewife
i am interested in reform and collection	search reform collection
i am interested in belt and competition	search belt competition
i am interested in alive and epicalyx	search alive epicalyx
i am interested in wolf and science	search wolf science
i am interested in rebel and shareholder	search rebel shareholder
i am interested in academy and vienna	search academy vienna
i am interested in topple and vertical	search topple vertical
i am interested in urgency and major	search urgency major
i am interested in north and bathtub	search north bathtub
i am interested in referee and depend	search referee depend
i am interested in jet and ambition	search jet ambition
i am interested in suite and entitlement	search suite entitlement
i am interested in likely and pound	search likely pound
i am interested in austria and distinct	search austria distinct
i am interested in residence and wien	search residence wien
i am interested in vegetable and man	search vegetable man
i am looking for major	search major
i am looking for referee	search referee
i am looking for distinct	search distinct
i am looking for point	search point
i am looking for economist	search economist
i am looking for entitlement	search entitlement
i am looking for depend	search depend
i am looking for residence	search residence
i am looking for classify	search classify
i am looking for essential	search essential
i am looking for dogs	search dogs
i am looking for ambition	search ambition
i am looking for shallow	search shallow
i am looking for doll	search doll
i am looking for tourist	search tourist
i am looking for vienna	search vienna
i am looking for alive	search alive
i am looking for north	search north
i am looking for urgency	search urgency
i am looking for expectation	search expectation
i am looking for break down	search break down
i am looking for jet	search jet
i am looking for motorist	search motorist
i am looking for reform	search reform
i am looking for rebel	search rebel
i am looking for academy	search academy
i am looking for reference	search reference
i am looking for austria	search austria
i am looking for wolf	search wolf
i am looking for pound	search pound
i am looking for topple	search topple
i am looking for competition	search competition
i am looking for man	search man
i am looking for housewife	search housewife
i am looking for recommend	search recommend
i am looking for shareholder	search shareholder
i am looking for wien	search wien
i am looking for twilight	search twilight
i am looking for manner	search manner
i am looking for vertical	search vertical
im interested in data about resident	search resident
im interested in data about vienna	search vienna
im interested in data about classify	search classify
im interested in data about collection	search collection
im interested in data about tourist	search tourist
im interested in data about break down	search break down
im interested in data about economist	search economist
im interested in data about rebel	search rebel
im interested in data about point	search point
im interested in data about distinct	search distinct
im interested in data about epicalyx	search epicalyx
im interested in data about belt	search belt
im interested in data about science	search science
im interested in data about topple	search topple
im interested in data about bathtub	search bathtub
im interested in data about recommend	search recommend
im interested in data about austria	search austria
im interested in data about jet	search jet
im interested in data about housewife	search housewife
im interested in data about residence	search residence
im interested in data about deserve	search deserve
im interested in data about wien	search wien
im interested in data about motorist	search motorist
im interested in data about manner	search manner
im interested in data about pound	search pound
im interested in data about dogs	search dogs
im interested in data about urgency	search urgency
im interested in data about likely	search likely
im interested in data about reference	search reference
im interested in data about referee	search referee
im interested in data about weed	search weed
im interested in data about alive	search alive
im interested in data about twilight	search twilight
im interested in data about ambition	search ambition
im interested in data about shallow	search shallow
im interested in data about escape	search escape
im interested in data about aluminium	search aluminium
im interested in data about expectation	search expectation
im interested in data about entitlement	search entitlement
im interested in data about doll	search doll
can you search for academy	search academy
can you search for shareholder	search shareholder
can you search for rebel	search rebel
can you search for residence	search residence
can you search for tourist	search tourist
can you search for competition	search competition
can you search for economist	search economist
can you search for likely	search likely
can you search for austria	search austria
can you search for break down	search break down
can you search for vienna	search vienna
can you search for essential	search essential
can you search for manner	search manner
can you search for expectation	search expectation
can you search for vegetable	search vegetable
can you search for man	search man
can you search for referee	search referee
can you search for wolf	search wolf
can you search for topple	search topple
can you search for housewife	search housewife
can you search for wien	search wien
can you search for major	search major
can you search for distinct	search distinct
can you search for science	search science
can you search for urgency	search urgency
can you search for dogs	search dogs
can you search for point	search point
can you search for ambition	search ambition
can you search for entitlement	search entitlement
can you search for bathtub	search bathtub
can you search for collection	search collection
can you search for epicalyx	search epicalyx
can you search for escape	search escape
can you search for belt	search belt
can you search for depend	search depend
can you search for resident	search resident
can you search for alive	search alive
can you search for north	search north
can you search for deserve	search deserve
can you search for pound	search pound
data concerning doll	search doll
data concerning austria	search austria
data concerning motorist	search motorist
data concerning urgency	search urgency
data concerning point	search point
data concerning dogs	search dogs
data concerning belt	search belt
data concerning north	search north
data concerning likely	search likely
data concerning vienna	search vienna
data concerning expectation	search expectation
data concerning escape	search escape
data concerning resident	search resident
data concerning weed	search weed
data concerning wien	search wien
data concerning science	search science
data concerning major	search major
data concerning manner	search manner
data concerning jet	search jet
data concerning ambition	search ambition
data concerning economist	search economist
data concerning essential	search essential
data concerning competition	search competition
data concerning vegetable	search vegetable
data concerning reform	search reform
data concerning railroad	search railroad
data concerning shareholder	search shareholder
data concerning topple	search topple
data concerning rebel	search rebel
data concerning break down	search break down
data concerning suite	search suite
data concerning pound	search pound
data concerning man	search man
data concerning residence	search residence
data concerning tourist	search tourist
data concerning wolf	search wolf
data concerning referee	search referee
data concerning entitlement	search entitlement
data concerning collection	search collection
data concerning distinct	search distinct
what do you have on distinct	search distinct
what do you have on topple	search topple
what do you have on shareholder	search shareholder
what do you have on alive	search alive
what do you have on twilight	search twilight
what do you have on dogs	search dogs
what do you have on resident	search resident
what do you have on belt	search belt
what do you have on entitlement	search entitlement
what do you have on economist	search economist
what do you have on competition	search competition
what do you have on essential	search essential
what do you have on wien	search wien
what do you have on referee	search referee
what do you have on north	search north
what do you have on classify	search classify
what do you have on shallow	search shallow
what do you have on austria	search austria
what do you have on break down	search break down
what do you have on epicalyx	search epicalyx
what do you have on railroad	search railroad
what do you have on likely	search likely
what do you have on manner	search manner
what do you have on pound	search pound
what do you have on collection	search collection
what do you have on housewife	search housewife
what do you have on vegetable	search vegetable
what do you have on residence	search residence
what do you have on reform	search reform
what do you have on man	search man
what do you have on jet	search jet
what do you have on doll	search doll
what do you have on tourist	search tourist
what do you have on suite	search suite
what do you have on escape	search escape
what do you have on reference	search reference
what do you have on rebel	search rebel
what do you have on expectation	search expectation
what do you have on vertical	search vertical
what do you have on major	search major
i am interested in datasets related to epicalyx	search epicalyx
i am interested in datasets related to ambition	search ambition
i am interested in datasets related to wolf	search wolf
i am interested in datasets related to point	search point
i am interested in datasets related to shareholder	search shareholder
i am interested in datasets related to classify	search classify
i am interested in datasets related to academy	search academy
i am interested in datasets related to wien	search wien
i am interested in datasets related to vegetable	search vegetable
i am interested in datasets related to doll	search doll
i am interested in datasets related to urgency	search urgency
i am interested in datasets related to break down	search break down
i am interested in datasets related to recommend	search recommend
i am interested in datasets related to deserve	search deserve
i am interested in datasets related to pound	search pound
i am interested in datasets related to escape	search escape
i am interested in datasets related to likely	search likely
i am interested in datasets related to reference	search reference
i am interested in datasets related to belt	search belt
i am interested in datasets related to distinct	search distinct
i am interested in datasets related to shallow	search shallow
i am interested in datasets related to railroad	search railroad
i am interested in datasets related to entitlement	search entitlement
i am interested in datasets related to competition	search competition
i am interested in datasets related to depend	search depend
i am interested in datasets related to north	search north
i am interested in datasets related to twilight	search twilight
i am interested in datasets related to major	search major
i am interested in datasets related to dogs	search dogs
i am interested in datasets related to housewife	search housewife
i am interested in datasets related to collection	search collection
i am interested in datasets related to weed	search weed
i am interested in datasets related to science	search science
i am interested in datasets related to motorist	search motorist
i am interested in datasets related to tourist	search tourist
i am interested in datasets related to residence	search residence
i am interested in datasets related to vertical	search vertical
i am interested in datasets related to jet	search jet
i am interested in datasets related to alive	search alive
i am interested in datasets related to reform	search reform
anything on austria	search austria
anything on railroad	search railroad
anything on collection	search collection
anything on pound	search pound
anything on reform	search reform
anything on point	search point
anything on referee	search referee
anything on classify	search classify
anything on residence	search residence
anything on academy	search academy
anything on shallow	search shallow
anything on topple	search topple
anything on likely	search likely
anything on tourist	search tourist
anything on reference	search reference
anything on epicalyx	search epicalyx
anything on depend	search depend
anything on deserve	search deserve
anything on vienna	search vienna
anything on belt	search belt
anything on motorist	search motorist
anything on ambition	search ambition
anything on dogs	search dogs
anything on vertical	search vertical
anything on bathtub	search bathtub
anything on north	search north
anything on man	search man
anything on urgency	search urgency
anything on competition	search competition
anything on weed	search weed
anything on economist	search economist
anything on aluminium	search aluminium
anything on wolf	search wolf
anything on jet	search jet
anything on expectation	search expectation
anything on vegetable	search vegetable
anything on recommend	search recommend
anything on resident	search resident
anything on escape	search escape
anything on science	search science
is there something about recommend	search recommend
is there something about competition	search competition
is there something about reference	search reference
is there something about jet	search jet
is there something about residence	search residence
is there something about depend	search depend
is there something about housewife	search housewife
is there something about alive	search alive
is there something about reform	search reform
is there something about motorist	search motorist
is there something about dogs	search dogs
is there something about austria	search austria
is there something about aluminium	search aluminium
is there something about wolf	search wolf
is there something about collection	search collection
is there something about topple	search topple
is there something about resident	search resident
is there something about expectation	search expectation
is there something about manner	search manner
is there something about referee	search referee
is there something about doll	search doll
is there something about ambition	search ambition
is there something about north	search north
is there something about economist	search economist
is there something about epicalyx	search epicalyx
is there something about likely	search likely
is there something about urgency	search urgency
is there something about vertical	search vertical
is there something about deserve	search deserve
is there something about distinct	search distinct
is there something about belt	search belt
is there something about wien	search wien
is there something about science	search science
is there something about escape	search escape
is there something about weed	search weed
is there something about essential	search essential
is there something about railroad	search railroad
is there something about vegetable	search vegetable
is there something about bathtub	search bathtub
is there something about suite	search suite
what have you got on escape	search escape
what have you got on twilight	search twilight
what have you got on classify	search classify
what have you got on vienna	search vienna
what have you got on weed	search weed
what have you got on tourist	search tourist
what have you got on suite	search suite
what have you got on major	search major
what have you got on reform	search reform
what have you got on manner	search manner
what have you got on resident	search resident
what have you got on economist	search economist
what have you got on alive	search alive
what have you got on jet	search jet
what have you got on aluminium	search aluminium
what have you got on vegetable	search vegetable
what have you got on belt	search belt
what have you got on academy	search academy
what have you got on rebel	search rebel
what have you got on recommend	search recommend
what have you got on doll	search doll
what have you got on epicalyx	search epicalyx
what have you got on science	search science
what have you got on railroad	search railroad
what have you got on essential	search essential
what have you got on shallow	search shallow
what have you got on ambition	search ambition
what have you got on depend	search depend
what have you got on shareholder	search shareholder
what have you got on point	search point
what have you got on topple	search topple
what have you got on motorist	search motorist
what have you got on competition	search competition
what have you got on pound	search pound
what have you got on likely	search likely
what have you got on dogs	search dogs
what have you got on distinct	search distinct
what have you got on reference	search reference
what have you got on austria	search austria
what have you got on urgency	search urgency
anything about entitlement ?	search entitlement
anything about jet ?	search jet
anything about break down ?	search break down
anything about manner ?	search manner
anything about vienna ?	search vienna
anything about vegetable ?	search vegetable
anything about shallow ?	search shallow
anything about economist ?	search economist
anything about escape ?	search escape
anything about depend ?	search depend
anything about major ?	search major
anything about motorist ?	search motorist
anything about wien ?	search wien
anything about likely ?	search likely
anything about suite ?	search suite
anything about distinct ?	search distinct
anything about topple ?	search topple
anything about urgency ?	search urgency
anything about residence ?	search residence
anything about competition ?	search competition
anything about dogs ?	search dogs
anything about doll ?	search doll
anything about bathtub ?	search bathtub
anything about ambition ?	search ambition
anything about epicalyx ?	search epicalyx
anything about rebel ?	search rebel
anything about belt ?	search belt
anything about essential ?	search essential
anything about housewife ?	search housewife
anything about deserve ?	search deserve
anything about expectation ?	search expectation
anything about reference ?	search reference
anything about academy ?	search academy
anything about resident ?	search resident
anything about pound ?	search pound
anything about alive ?	search alive
anything about recommend ?	search recommend
anything about wolf ?	search wolf
anything about twilight ?	search twilight
anything about point ?	search point
data regarding aluminium	search aluminium
data regarding distinct	search distinct
data regarding vienna	search vienna
data regarding weed	search weed
data regarding wien	search wien
data regarding likely	search likely
data regarding depend	search depend
data regarding economist	search economist
data regarding reform	search reform
data regarding epicalyx	search epicalyx
data regarding tourist	search tourist
data regarding vegetable	search vegetable
data regarding recommend	search recommend
data regarding resident	search resident
data regarding topple	search topple
data regarding motorist	search motorist
data regarding shareholder	search shareholder
data regarding pound	search pound
data regarding ambition	search ambition
data regarding dogs	search dogs
data regarding classify	search classify
data regarding wolf	search wolf
data regarding doll	search doll
data regarding jet	search jet
data regarding suite	search suite
data regarding railroad	search railroad
data regarding major	search major
data regarding entitlement	search entitlement
data regarding essential	search essential
data regarding north	search north
data regarding manner	search manner
data regarding urgency	search urgency
data regarding reference	search reference
data regarding expectation	search expectation
data regarding belt	search belt
data regarding academy	search academy
data regarding bathtub	search bathtub
data regarding austria	search austria
data regarding alive	search alive
data regarding break down	search break down
data concerning science	search science
data concerning jet	search jet
data concerning vegetable	search vegetable
data concerning urgency	search urgency
data concerning belt	search belt
data concerning north	search north
data concerning expectation	search expectation
data concerning motorist	search motorist
data concerning reference	search reference
data concerning austria	search austria
data concerning aluminium	search aluminium
data concerning epicalyx	search epicalyx
data concerning vertical	search vertical
data concerning topple	search topple
data concerning collection	search collection
data concerning competition	search competition
data concerning break down	search break down
data concerning bathtub	search bathtub
data concerning manner	search manner
data concerning academy	search academy
data concerning economist	search economist
data concerning major	search major
data concerning reform	search reform
data concerning wolf	search wolf
data concerning ambition	search ambition
data concerning depend	search depend
data concerning wien	search wien
data concerning dogs	search dogs
data concerning housewife	search housewife
data concerning man	search man
data concerning referee	search referee
data concerning rebel	search rebel
data concerning entitlement	search entitlement
data concerning shareholder	search shareholder
data concerning alive	search alive
data concerning resident	search resident
data concerning vienna	search vienna
data concerning suite	search suite
data concerning doll	search doll
data concerning twilight	search twilight
i am very interested in data related to wien	search wien
i am very interested in data related to residence	search residence
i am very interested in data related to break down	search break down
i am very interested in data related to tourist	search tourist
i am very interested in data related to recommend	search recommend
i am very interested in data related to epicalyx	search epicalyx
i am very interested in data related to twilight	search twilight
i am very interested in data related to rebel	search rebel
i am very interested in data related to reference	search reference
i am very interested in data related to likely	search likely
i am very interested in data related to academy	search academy
i am very interested in data related to essential	search essential
i am very interested in data related to north	search north
i am very interested in data related to man	search man
i am very interested in data related to austria	search austria
i am very interested in data related to urgency	search urgency
i am very interested in data related to resident	search resident
i am very interested in data related to classify	search classify
i am very interested in data related to depend	search depend
i am very interested in data related to ambition	search ambition
i am very interested in data related to alive	search alive
i am very interested in data related to vertical	search vertical
i am very interested in data related to point	search point
i am very interested in data related to collection	search collection
i am very interested in data related to manner	search manner
i am very interested in data related to dogs	search dogs
i am very interested in data related to entitlement	search entitlement
i am very interested in data related to science	search science
i am very interested in data related to belt	search belt
i am very interested in data related to shallow	search shallow
i am very interested in data related to vegetable	search vegetable
i am very interested in data related to wolf	search wolf
i am very interested in data related to motorist	search motorist
i am very interested in data related to economist	search economist
i am very interested in data related to aluminium	search aluminium
i am very interested in data related to referee	search referee
i am very interested in data related to topple	search topple
i am very interested in data related to suite	search suite
i am very interested in data related to escape	search escape
i am very interested in data related to major	search major
science?	search science
competition?	search competition
north?	search north
vienna?	search vienna
pound?	search pound
tourist?	search tourist
depend?	search depend
shallow?	search shallow
vegetable?	search vegetable
alive?	search alive
classify?	search classify
aluminium?	search aluminium
vertical?	search vertical
recommend?	search recommend
distinct?	search distinct
austria?	search austria
essential?	search essential
weed?	search weed
likely?	search likely
epicalyx?	search epicalyx
shareholder?	search shareholder
residence?	search residence
housewife?	search housewife
manner?	search manner
ambition?	search ambition
expectation?	search expectation
dogs?	search dogs
motorist?	search motorist
entitlement?	search entitlement
deserve?	search deserve
collection?	search collection
rebel?	search rebel
wien?	search wien
suite?	search suite
reference?	search reference
bathtub?	search bathtub
urgency?	search urgency
resident?	search resident
doll?	search doll
major?	search major
im interested in datasets on dogs	search dogs
im interested in datasets on suite	search suite
im interested in datasets on weed	search weed
im interested in datasets on epicalyx	search epicalyx
im interested in datasets on topple	search topple
im interested in datasets on break down	search break down
im interested in datasets on north	search north
im interested in datasets on academy	search academy
im interested in datasets on recommend	search recommend
im interested in datasets on tourist	search tourist
im interested in datasets on manner	search manner
im interested in datasets on vienna	search vienna
im interested in datasets on deserve	search deserve
im interested in datasets on austria	search austria
im interested in datasets on bathtub	search bathtub
im interested in datasets on aluminium	search aluminium
im interested in datasets on wolf	search wolf
im interested in datasets on economist	search economist
im interested in datasets on essential	search essential
im interested in datasets on alive	search alive
im interested in datasets on collection	search collection
im interested in datasets on distinct	search distinct
im interested in datasets on belt	search belt
im interested in datasets on reform	search reform
im interested in datasets on competition	search competition
im interested in datasets on major	search major
im interested in datasets on vertical	search vertical
im interested in datasets on twilight	search twilight
im interested in datasets on wien	search wien
im interested in datasets on escape	search escape
im interested in datasets on expectation	search expectation
im interested in datasets on residence	search residence
im interested in datasets on rebel	search rebel
im interested in datasets on entitlement	search entitlement
im interested in datasets on point	search point
im interested in datasets on shareholder	search shareholder
im interested in datasets on reference	search reference
im interested in datasets on doll	search doll
im interested in datasets on ambition	search ambition
im interested in datasets on motorist	search motorist
im interested in data concerning rebel	search rebel
im interested in data concerning collection	search collection
im interested in data concerning north	search north
im interested in data concerning manner	search manner
im interested in data concerning railroad	search railroad
im interested in data concerning competition	search competition
im interested in data concerning austria	search austria
im interested in data concerning distinct	search distinct
im interested in data concerning economist	search economist
im interested in data concerning wolf	search wolf
im interested in data concerning epicalyx	search epicalyx
im interested in data concerning point	search point
im interested in data concerning ambition	search ambition
im interested in data concerning shallow	search shallow
im interested in data concerning reference	search reference
im interested in data concerning motorist	search motorist
im interested in data concerning urgency	search urgency
im interested in data concerning alive	search alive
im interested in data concerning entitlement	search entitlement
im interested in data concerning escape	search escape
im interested in data concerning suite	search suite
im interested in data concerning deserve	search deserve
im interested in data concerning vegetable	search vegetable
im interested in data concerning essential	search essential
im interested in data concerning break down	search break down
im interested in data concerning jet	search jet
im interested in data concerning vienna	search vienna
im interested in data concerning shareholder	search shareholder
im interested in data concerning likely	search likely
im interested in data concerning housewife	search housewife
im interested in data concerning expectation	search expectation
im interested in data concerning recommend	search recommend
im interested in data concerning classify	search classify
im interested in data concerning aluminium	search aluminium
im interested in data concerning topple	search topple
im interested in data concerning academy	search academy
im interested in data concerning depend	search depend
im interested in data concerning science	search science
im interested in data concerning weed	search weed
im interested in data concerning wien	search wien
i need data on ambition	search ambition
i need data on wolf	search wolf
i need data on vegetable	search vegetable
i need data on manner	search manner
i need data on wien	search wien
i need data on science	search science
i need data on distinct	search distinct
i need data on austria	search austria
i need data on break down	search break down
i need data on north	search north
i need data on dogs	search dogs
i need data on shallow	search shallow
i need data on rebel	search rebel
i need data on suite	search suite
i need data on reform	search reform
i need data on bathtub	search bathtub
i need data on urgency	search urgency
i need data on topple	search topple
i need data on likely	search likely
i need data on entitlement	search entitlement
i need data on competition	search competition
i need data on collection	search collection
i need data on economist	search economist
i need data on railroad	search railroad
i need data on pound	search pound
i need data on referee	search referee
i need data on tourist	search tourist
i need data on weed	search weed
i need data on twilight	search twilight
i need data on man	search man
i need data on housewife	search housewife
i need data on reference	search reference
i need data on motorist	search motorist
i need data on jet	search jet
i need data on major	search major
i need data on vienna	search vienna
i need data on doll	search doll
i need data on escape	search escape
i need data on academy	search academy
i need data on belt	search belt
maybe something on referee	search referee
maybe something on collection	search collection
maybe something on wolf	search wolf
maybe something on essential	search essential
maybe something on entitlement	search entitlement
maybe something on belt	search belt
maybe something on depend	search depend
maybe something on vienna	search vienna
maybe something on austria	search austria
maybe something on major	search major
maybe something on shareholder	search shareholder
maybe something on wien	search wien
maybe something on residence	search residence
maybe something on academy	search academy
maybe something on vegetable	search vegetable
maybe something on urgency	search urgency
maybe something on housewife	search housewife
maybe something on ambition	search ambition
maybe something on topple	search topple
maybe something on epicalyx	search epicalyx
maybe something on motorist	search motorist
maybe something on resident	search resident
maybe something on deserve	search deserve
maybe something on vertical	search vertical
maybe something on classify	search classify
maybe something on economist	search economist
maybe something on escape	search escape
maybe something on science	search science
maybe something on doll	search doll
maybe something on tourist	search tourist
maybe something on recommend	search recommend
maybe something on competition	search competition
maybe something on suite	search suite
maybe something on expectation	search expectation
maybe something on north	search north
maybe something on railroad	search railroad
maybe something on reform	search reform
maybe something on aluminium	search aluminium
maybe something on break down	search break down
maybe something on weed	search weed
im looking for something related to railroad or point	search railroad point
im looking for something related to science or dogs	search science dogs
im looking for something related to escape or jet	search escape jet
im looking for something related to tourist or vertical	search tourist vertical
im looking for something related to urgency or wolf	search urgency wolf
im looking for something related to rebel or belt	search rebel belt
im looking for something related to referee or recommend	search referee recommend
im looking for something related to entitlement or economist	search entitlement economist
im looking for something related to weed or alive	search weed alive
im looking for something related to resident or residence	search resident residence
im looking for something related to distinct or austria	search distinct austria
im looking for something related to pound or topple	search pound topple
im looking for something related to north or reform	search north reform
im looking for something related to bathtub or vegetable	search bathtub vegetable
im looking for something related to essential or motorist	search essential motorist
im looking for something related to aluminium or suite	search aluminium suite
im looking for something related to vienna or housewife	search vienna housewife
im looking for something related to deserve or man	search deserve man
im looking for something related to shareholder or manner	search shareholder manner
im looking for something related to depend or competition	search depend competition
im looking for something related to expectation or doll	search expectation doll
im looking for something related to break down or wien	search break down wien
im looking for something related to ambition or twilight	search ambition twilight
im looking for something related to epicalyx or classify	search epicalyx classify
im looking for something related to major or collection	search major collection
im looking for something related to academy or shallow	search academy shallow
im looking for something related to reference or likely	search reference likely
how about vienna?	search vienna
how about motorist?	search motorist
how about depend?	search depend
how about shareholder?	search shareholder
how about reform?	search reform
how about pound?	search pound
how about vegetable?	search vegetable
how about deserve?	search deserve
how about escape?	search escape
how about residence?	search residence
how about reference?	search reference
how about point?	search point
how about epicalyx?	search epicalyx
how about academy?	search academy
how about jet?	search jet
how about wolf?	search wolf
how about housewife?	search housewife
how about essential?	search essential
how about vertical?	search vertical
how about science?	search science
how about man?	search man
how about railroad?	search railroad
how about twilight?	search twilight
how about manner?	search manner
how about shallow?	search shallow
how about likely?	search likely
how about major?	search major
how about referee?	search referee
how about ambition?	search ambition
how about urgency?	search urgency
how about topple?	search topple
how about collection?	search collection
how about belt?	search belt
how about resident?	search resident
how about doll?	search doll
how about recommend?	search recommend
how about wien?	search wien
how about north?	search north
how about entitlement?	search entitlement
how about expectation?	search expectation
